XXXXXXXXXXXXXXXXXXXXXXXXXXXX
XÖ          .XX            X
X XXXX XXXXX XX XXXXX XXXX X
X XXXX XXXXX XX XXXXX XXXX X
X XXXX XXXXX    XXXXX XXXX X
X XXXX XXXXX XX XXXXX XXXX X
X XXXX XXo   XX    XX XXXX X
X         XXXXXXXX         X
X XXXXXXX XXXXXXXX XXXXXXX X
X XXXXXXX    XX    XXXXXXX X
X      XXXXX XX XXXXXo     X
X XXXX XXXXX XX XXXXX XXXX X
X XXXX                XXXX X
X XXXX XX XXX  XXX XX XXXX X
X XXXX XX X      X XX XXXX X
1      XX X  BP  X XX      1
X XXXX XX X  IC  X XX XXXX X
X XXXX XX XXXXXXXX XX XXXX X
X XX          v         XX X
X XX XXXXXXXXXXXXXXXXXX XX X
X    XXXXXXXXXXXXXXXXXX    X
X XX                    XX X
X XX XXX XXXXXXXXXX XXX XX X
X XX XXX XXXXXXXXXX XXX XX X
X XX XXX     XX     XXX XX X
X XX XXX XXX XX XXX XXX XX X
X XXo    XXX    XXXo    XX X
X XXXX XXXXX XX XXXXX XXXX X
X XXXX XXXXX XX XXXXX XXXX X
X            XX            X
XXXXXXXXXXXXXXXXXXXXXXXXXXXX