XXXXXXXXXXXXXXXXXXXXXXXXXXXX
XC...........XX............X
X.XXXX.XXXXX.XX.XXXXX.XXXX.X
X.XXXX.XXXXX....XXXXX.XXXX.X
X.XXXX.XXXXX.XX.XXXXX.XXXX.X
X..o.........XX............X
X.XXXX.XX.XXXXXXXX.XX.XXXX.X
X.XXXX.XX.XXXXXXXX.XX.XXXX.X
X......XX....XX....XX......X
XXX.XX.XXXXX.XX.XXXXX.XX.XXX
XXX.XX.XXXXX.XX.XXXXX.XX.XXX
X...XX................XXo..X
X.XXXX.XX.XXX..XXX.XX.XXXX.X
X.XXXX.XX.X......X.XX.XXXX.X
 ......XX.X.H....X.XX...... 
X.XXXX.XX.X......X.XX.XXXX.X
X.XXXX.XX.XXXXXXXX.XX.XXXX.X
X...XX.XX.....v....XX.XX...X
XXX.XX.XX.XXXXXXXX.XX.XX.XXX
XXX.XX.XX.XXXXXXXX.XX.XX.XXX
Xo.........................X
X.XXXX.XXXXX.XX.XXXXX.XXXX.X
X.XXXX.XXXXX.XX.XXXXX.XXXX.X
X...XX.......XX.......XXo..X
XXX.XX.XX.XXXXXXXX.XX.XX.XXX
XXX.XX.XX.XXXXXXXX.XX.XX.XXX
X......XX....XX....XX......X
X.XXXX.XXXXX.XX.XXXXX.XXXX.X
X.XXXX.XXXXX.XX.XXXXX.XXXX.X
X..........................X
XXXXXXXXXXXXXXXXXXXXXXXXXXXX